                                                                                      7                                                                                                                    
                  7                                                  0                                                                  3                                               00000000 00000000  
                       3           3   0      5    3               3 0     0                      3                                                                       3                                
            5                  4       0  3     7               7    0     0        7        0            0            0                        3       0        7                  3     0 0 3 0  0 30 03 
  5            7                       0      4                      0     0       5         0          3 0         3  0                   0            0   3              0              0 0   0 0   0 0  
   5                                   0                 3   4       7     0                 0                         0       7        7  0        7   0                  0              0 00  0 00  0 0  
                            5     7    0            0                      0       1         0            0    5       0   7               0            0                  0 3       3   00  0  0  0  0 0  
   44       7          5               7      7     0        7             0       7         0            0        7   0                   0   3        0      7      3                  0   0  0 30  0 0  
                               4                    0  7                   7                 0   3  7     0            0          3        0            0      3           0        7   3 0 30  0  0 30 03 
            1     3         3  7                    0                3                       0           77    7       7                   0            0                  7    7         0  0  0  0  0    
777777  7   7                         3    7    3   0   3                                    0                         3           7       0            0                                 0  0  0  0  0 06 
                       7    7                       7     7                      7           7    7                                        7    7       7    7         7                7777777777777777777
