                                                                                                                                                                                                       0            77     44      55               22    
                    3                                                                                                                                                                                  0 6                                                
                                                                              7                         0                                                                         3                    0 7                         5                 2  7 
45                   0        7     1   0                                 0                             0   7                  3                          0                      3                     0                                                  
45         33 3      0              7   0            3                    0                         33  0                     3                    3 3    0        7            3       0              0                   77      77               22    
45                   0   7              0           3   0          3  3   0       0 3                   0                    30                 33        0                 0           0       3      7                                                  
45                   0                  0               0                 0       03              1     0                    30                           0                 0           0     33                                        3            2  0 
                     0                  0               0                 0       0         7     7     7      3              0                           0    7            0     1    00                                                                 
           7         7                  7               0                 7       0                          3                0  7                  7     0          3      0     7    00          1         77                                          1
                                  3 3                   0      1                  0                                           0                           7       33        0          00          7                                                      
777   7         7                             7    7    7      7     7            0                                     1     0                1                            0           7                                                 7777777777777777
                                                                                  7     7                        7      7     7         7      7                            7                  7                                                          
